11111111111111
1P0100C0010111
100C0010C10101

11000C01100001
11111111111111