1111111111
110P100C01
110000P001
110C00P111
11E0000111
1111111111