11111
1P001
10001
10011
100E1
11111