111111111
110100C01
10P000001
10C000111
1110001E1
100000111
111111111