1111111111111
1P010
10C00000001
10C0
10
111111111