1111111111
11011111E1
1100111101
1100C11101
1101001101
11C1100101
1101110001
11P0000001
1110001111
1111111111
