111111111111
1P11000010C1
10000C001001
10E000000001
111111111111
