111111
100001
10C0E1
1000P1
111111