11111111111111111111111111111
10111110000X00000000000000001
1001111010000100101100C0X0001
100C1110100001001000000000001
10100110100010001000011000001
1C000000000000000000000000001
101110001000X0C110000000111E1
1P000000000000010100011001X01
11000111100X0100000101C000001
11111111111111111111111111111
