11111111111111111111111111111
10111110000000000000000000001
1001111010000100101100C000001
100C1110100001001000000000001
10100110100010001000011000001
1C110010100000001111100001011
10111000100000C110000000111E1
10P00000000000010100011001001
1100011110000100000101C000001
11111111111111111111111111111
